札幌市	h
仙台市	h
新潟市	h
さいたま市	t
千葉市	t
横浜市	t
川崎市	t
相模原市	t
静岡市	c
浜松市	c
名古屋市	c
京都市	k
大阪市	k
堺市	k
神戸市	k
岡山市	s
広島市	s
北九州市	s
福岡市	s
熊本市	s